NO ./textures/brick.xpm
SO ./textures/blue.xpm
WE ./textures/wood.xpm
EA ./textures/grey.xpm

F 86,125,70
C 132,206,235

 111111111111111111111111111111
11111000000000010000000000001
111111111111110010000000000001
100000000000000000000000000001
100000000000001111111111000001
100000000000001110000000000001
111000000000001110000000000001
100000000000000000000000000001
100000000000000000000000000001
1000000000000000000000000W0011
100000000000000000000000000001
100000000000000000000000000001
100000000000000000000000000001
100011111111111111111111110001
100000000000000000000000000001
10011000000000000000000000001
1111 1111111111111111111111111
