NO ./textures/brick.xpm
SO ./textures/blue.xpm
WE ./textures/wood.xpm
EA ./textures/grey.xpm

C 49,8,123
F 28,109,208


        1111111111111111111111111
        1000000000110000000000001
        1011000000010000000000001
        1001000000000000000000001
111111111011000000010000000000001
100000000011000001110111110111111
111101111111110111000000000001
111101111111101111010100000011
1100000011010000000000000000001
100000000000001011000000000011
100000000000000011010100000001
11000001110101011111011110N011
11110111 1110101 101111010001
11111111 1111111 111111111111