NO ./textures/water.xpm
SO ./textures/water.xpm
WE ./textures/water.xpm
EA ./textures/water.xpm

F 62,66,75
C 102,51,153

111111111111111111111111
100000000000100000000011
100000000000100000000001
100000000000100000000001
111101111001111001010001
100001000000001000010001
101000000000000000010001
100001000000001000010001
100001110101011001010001
100000000000000000000001
100000000000000000000001
100000000000000000000001
100000000000000000001001
100000000000000000110001
100000000101101000001001
100000000000000000000001
111111111100000011000001
110100001000000000000001
110000101110000010000001
110000001000000000000001
110111111000001000000001
110000000000000110000001
111111111010S00010000001
111111111111111111111111
