NO ./textures/brick.xpm
SO ./textures/blue.xpm
WE ./textures/wood.xpm
EA ./textures/grey.xpm

F 00,100,0
C 05,30,0

111111111
110000001
  1111S0011
111100111
1110001
1111111

