NO ./textures/brick.xpm
SO ./textures/blue.xpm
WE ./textures/wood.xpm
EA ./textures/grey.xpm

F 86,125,70
C 132,106,235

111111111111111111111111111
100001010010000000011000101
100000010010111111011010001
100001010010100001011011011
111111110010101101011010001
100000000010111101000011011
101111111010000001000010001
101110111011111111111111011
101110111000000000000000001
101110111000000010100000001
101110111000000010100000001
101000001000000100010000001
101110111000011000001100001
10111011100001000N000100001
101110111000011000001100001
101110111000000100010000001
101110111000000010100000001
101111111000000011100000001
100000000000000000000000001
111111111111111111111111111
